##########
#........#
#..k.@...#
#........#
##########
