##########
#.....s..#
#..###...#
#..#@....#
#..###.k#
#.......#
##########
